%%%%%%%%%%%%%%%%%%%%%%%%
%.. P  ...G     ....   %
%..  ...  ... %%%  ... %
%..  ..%  ... ..%  ... %
%..    %%%%   %%%... G %
%.G  ...  %.. ...  ... %
%..  ...  %%% ...  ... %
%%%%%%%%%%%%%%%%%%%%%%%%
